#######################################
# Syntax Coloring Map SPI
#######################################

#######################################
# Datatypes (KEYWORD1)
#######################################
TLcdPinAssignTable	KEYWORD1
MGLCD_serial	KEYWORD1
MGLCD_SoftwareSerial	KEYWORD1
MGLCD_S12232ZA	KEYWORD1
MGLCD_SG12232	KEYWORD1
MGLCD_SG12864	KEYWORD1
MGLCD_AQM1248A_SPI	KEYWORD1
MGLCD_AQM1248A_SoftwareSPI	KEYWORD1
MGLCD_GH12864_20_SPI	KEYWORD1
MGLCD_GH12864_20_SoftwareSPI	KEYWORD1
#######################################
# Methods and Functions (KEYWORD2)
#######################################
Backlight	KEYWORD2
ChangeBaudRate	KEYWORD2
Circle	KEYWORD2
ClearRestOfLine	KEYWORD2
ClearScreen	KEYWORD2
Contrast	KEYWORD2
DrawBitmap	KEYWORD2
FillCircle	KEYWORD2
FillRect	KEYWORD2
GetCodeMode	KEYWORD2
GetColumnNum	KEYWORD2
GetConstructionError	KEYWORD2
GetHeight	KEYWORD2
GetInvertMode	KEYWORD2
GetLineNum	KEYWORD2
GetPageNum	KEYWORD2
GetPixel	KEYWORD2
GetScrollMode	KEYWORD2
GetTextWindow	KEYWORD2
GetWidth	KEYWORD2
GetX	KEYWORD2
GetY	KEYWORD2
InvertDisplay	KEYWORD2
Led	KEYWORD2
Line	KEYWORD2
Locate	KEYWORD2
PutChar	KEYWORD2
ReadButton	KEYWORD2
ReadData	KEYWORD2
Rect	KEYWORD2
Reset	KEYWORD2
RoundRect	KEYWORD2
SetCodeMode	KEYWORD2
SetInvertMode	KEYWORD2
SetLcdBiasRatio	KEYWORD2
SetTextWindow	KEYWORD2
SetPixel	KEYWORD2
SetRegulatorVoltage	KEYWORD2
SetScrollMode	KEYWORD2
SetVbiasPotentiometer KEYWORD2
SetVolumeResistor	KEYWORD2
UserChars	KEYWORD2
WaitForButtons	KEYWORD2
WriteData	KEYWORD2
#######################################
# Constants (LITERAL1)
#######################################
MGLCD_BACKLIGHT_OFF	LITERAL1
MGLCD_BACKLIGHT_ON	LITERAL1
MGLCD_BUTTON_OFF	LITERAL1
MGLCD_BUTTON_ON	LITERAL1
MGLCD_COMMAND	LITERAL1
MGLCD_COMMUNICATION_ERROR	LITERAL1
MGLCD_CS1	LITERAL1
MGLCD_CS1_COMMAND	LITERAL1
MGLCD_CS1_CS2_DATA	LITERAL1
MGLCD_CS1_CS2	LITERAL1
MGLCD_CS1_CS2_COMMAND	LITERAL1
MGLCD_CS1_DATA	LITERAL1
MGLCD_CS2	LITERAL1
MGLCD_CS2_COMMAND	LITERAL1
MGLCD_CS2_DATA	LITERAL1
MGLCD_DATA 	LITERAL1
MGLCD_FONT_HEIGHT	LITERAL1
MGLCD_FONT_WIDTH	LITERAL1
MGLCD_GET_BACKLIGHT_STATE	LITERAL1
MGLCD_GET_BUTTON_NUM	LITERAL1
MGLCD_GET_CURRENT_CONTRAST	LITERAL1
MGLCD_GET_DEFAULT_CONTRAST	LITERAL1
MGLCD_GET_LED_NUM	LITERAL1
MGLCD_GET_LED_STATE	LITERAL1
MGLCD_INVERT	LITERAL1
MGLCD_LED_BLINK	LITERAL1
MGLCD_LED_OFF	LITERAL1
MGLCD_LED_ON	LITERAL1
MGLCD_LED_TOGGLE	LITERAL1
MGLCD_MAX_CONTRAST	LITERAL1
MGLCD_NON_INVERT	LITERAL1
MGLCD_NON_SCROLL	LITERAL1
MGLCD_NOT_SET_DEFAULT	LITERAL1
MGLCD_RAM	LITERAL1
MGLCD_ROM	LITERAL1
MGLCD_SCROLL	LITERAL1
MGLCD_SET_DEFAULT	LITERAL1
MGLCD_UNUSED_PIN	LITERAL1
MGLCD_VERSION	LITERAL1
MGLCD_CODE_STRAIGHT	LITERAL1
MGLCD_CODE_UTF8	LITERAL1
